                                                  
 A                           ##                   
                              #                   
                           #   #                  
            ##           # #   #            #     
            ##          ### #  ##     #   ###     
         ##  ##  #     #### #  ##    ### ####     
          ## #  ##     #####  ##   ## # #### #    
          ##  ###   ##  #### #  ## #  ####  ###   
              ##     #  #####  ### #   ##  ## #   
            #      # ## ####   ###  #    # ## #   
      ##   ###    ##  #  #  #  ####      # ## #   
      ##  ###    ##   #    ###  ###   ## ###      
  ##   ## ##     #     #  ####  ###  ###          
   #   ##     ##       #  #####    # ###          
   ##   #    ##        ##  ####   ## ### #        
    ##      ##  #       #  ##   ##### ##          
    ##                  ##     ###### #  # #      
          #      #       #   ########    #####    
          ##           #    ##########   # #    # 
           #      #   ##    ##########   ##    ## 
       ##  #      #  ##   #  ########## ##   ##   
        #          #    #### ##########      ##   
        ##       ###     ###  #########   ##      
             #   ##     ####  #######    ### #    
  #          ##  #      ##### ######     #####    
              ##         ####  ####   ### ####    
   ##    #    #          ####  ##    #### ###     
  ###                     ###      ###### ##  ##  
 #####                     #      #####     ## #  
    ##                           #####     ##  ## 
    ###                          ######  ## ##### 
   ####                          ###### ###  ##   
    #####                        #####   # # #    
     ## #     #                   ##  #    ##     
                          ##      #  ##     #     
                        ####        ### ##  ##    
    #                   ####       ###  ## #      
 # ##                    ##        #  ## ###      
  ####                               # # ##       
   ###    # #    ##                 #  ##    ##   
   ##     ##    ###                 ## ##   ##    
    #          #####                 ###    #     
              ######                 ##   #       
             ########                     #       
             #######                              
             ######                               
              ####                                
               #                                B 
                                                  
