############################
#A     #         #         #
# #####  #####    #####    #
#       #     #            #
# ####### ### ###########  #
#       #   #         #    #
#   ######### ####### #    #
#   #         #       #    #
#   # ####### #########    #
#   #       #         #    #
#   ######### ####### #    #
#           #       # #    #
# ########### ##### # #    #
#             #     # #    #
###################B########